{
    "1": {
        "name": "First level",
        "field": [
            [0,0,0,0,0,0,0,0,0,0,0],
            [0,0,0,0,0,0,0,0,0,0,0],
            [0,0,1,1,1,1,0,0,0,0,0],
            [0,0,1,0,0,1,0,0,1,2,0],
            [1,1,1,0,0,1,1,1,1,0,0],
            [0,0,0,0,0,0,0,0,0,0,0],
            [0,0,0,0,0,0,0,0,0,0,0]
        ],
        "path": [
            [0,4], [1,4], [2,4], [2,3], [2,2], [3,2], [4,2], [5,2],
            [5,3], [5,4], [6,4], [7,4], [8,4], [8,3], [9,3]
        ]
    }
}